#####
#.@ #
# $ #
#   #
#####
