 ######
##+#  #
# $   #
#   $ #
#### ##
#     #
#  * .#
#  #  #
#######
