##### 
#   ##
#  $@#
##$ .#
 #  .#
 #####
