########
# @#   #
# *$   #
#  #  ##
#. #  # 
####### 
