#####   
# . ####
#  $@  #
##*    #
 #  ####
 ####   
