#######
#. $. #
##    #
#.  ###
### * #
#@$ $ #
# $ . #
#  ####
#  #   
####   