##########
#   ##   #
#  $#  . #
#   # $.##
##   $ *@#
 #  ## .##
 ######## 